1 0 1 0 ■
1 2 1 2 ■
1 4 1 4 ■
1 6 1 6 ■
1 8 1 8 ■
1 10 1 10 ■
2 1 2 1 ■
2 3 2 3 ■
2 5 2 5 ■
2 7 2 7 ■
2 9 2 9 ■
2 11 2 11 ■
3 0 3 0 ■
3 2 3 2 ■
3 4 3 4 ■
3 6 3 6 ■
3 8 3 8 ■
3 10 3 10 ■
4 1 4 1 ■
4 3 4 3 ■
4 5 4 5 ■
4 7 4 7 ■
4 9 4 9 ■
4 11 4 11 ■
